xxxxxxxSxxxxxxx
x0x000x00000E0x
x0x0xx00xx0x0xx
x000000xx00x0xx
x0xxxx0xx0x000x
x000xx00x0xxx0x
x0x0xxxx00000xx
x0x0x0000xxx0xx
x00xx0xx0x000xx
x0xx00000x0xxxx
x000xxxx0x00xxx
xxx0x0000xx000x
x000x0xxxxx0xxx
x0xxx0x0000000x
xxxxxxxxxxxxxxx